TangibleObject	Entity
IntangibleObject	Entity
Shish	Entity
GPE	Shish
PER	Shish
FAC	Shish
ActivityField	Shish
HumanLivingBeing	TangibleObject
NonHumanLivingBeing	TangibleObject
LivingBodyPart	TangibleObject
NonLivingPart	TangibleObject
Vehicle	TangibleObject
Weapon	TangibleObject
Artifact	TangibleObject
Collection	IntangibleObject
Relation	IntangibleObject
ImmeasurableObject	IntangibleObject
InformationObject	IntangibleObject
MentalObject	IntangibleObject
MeasurableAbstraction	IntangibleObject
ShapeAndStructureAbstraction	MeasurableAbstraction
Org	Collection
SocialGroup	Collection
NonOrgGroup	Collection
Mob	NonOrgGroup
Movement	NonOrgGroup
Family	Org
MilitaryOrg	Org
PoliticalOrg	Org
CommercialOrg	Org
CivilianVehicle	Vehicle
MilitaryVehicle	Vehicle
Missile	Weapon
Time	MeasurableAbstraction
Loc	MeasurableAbstraction
UrbanArea	Loc
RuralArea	Loc
ShapeAndStructureAbstraction	MeasurableAbstraction