man	HumanLivingBeing
woman	HumanLivingBeing
child	HumanLivingBeing
body	HumanLivingBeing
people	HumanLivingBeing
russian	PER
ukrainian	PER
figure	PER
official	PER
soldier	PER
journalist	PER
user	PER
locals	PER
member	PER
separatist	PER
witness	PER
suspect	PER
eyewitness	PER
resident	PER
journalist	PER
user	PER
karapetyan	PER
reznikov	PER
vasily	PER
ivan	PER
ilych	PER
ilyin	PER
arm	LivingBodyPart
hand	LivingBodyPart
dog	NonHumanLivingBeing
russia	GPE
paris	GPE
malaysia	GPE
ukraine	GPE
USA	GPE
EU	GPE
Game	ActivityField
Science	ActivityField
Politics	ActivityField
Medicine	ActivityField
ministry	PoliticalOrg
board	CommercialOrg
company	CommercialOrg
airline	CommercialOrg
military	MilitaryOrg
team	MilitaryOrg
brigade	MilitaryOrg
car	CivilianVehicle
truck	CivilianVehicle
rental vehicle	CivilianVehicle
satellite	MilitaryVehicle
transport	MilitaryVehicle
transporter	MilitaryVehicle
convoy	MilitaryVehicle
loader	MilitaryVehicle
low-loader	MilitaryVehicle
tank	MilitaryVehicle
launcher	MilitaryVehicle
flight	Vehicle
mh17	Vehicle
aircraft	Vehicle
airplane	Vehicle
m-1	Missile
sa-11	Missile
surface-to-air	Missile
buk	Missile
m21	Missile	
aircraft-part	NonLivingPart
cabin	NonLivingPart
wing	NonLivingPart
wreckage	NonLivingPart
plate	NonLivingPart
paint	Artifact
tool	Artifact
net	Artifact
clock	InfoInstrument
phone	InfoInstrument
billboard	InfoInstrument
physicalmaterial	NaturalNonLivingObject
gasoline	NaturalNonLivingObject
river	NaturalNonLivingObject
element	NaturalNonLivingObject
text	TextInfo
post	TextInfo
summary	TextInfo
report	TextInfo
case	TextInfo
statement	TextInfo
tweet	TextInfo
profile	TextInfo
note	TextInfo
page	TextInfo
recording	SpeechInfo
noise	SpeechInfo
fingerprint	ImageInfo
photograph	ImageInfo
mark	ImageInfo
screenshot	ImageInfo
news	ImageInfo
footage	ImageInfo
photo	ImageInfo
imagery	ImageInfo
map	ImageInfo
image	ImageInfo
video	ImageInfo
marking	ImageInfo
buzzfeed	SocialMedium
youtube	SocialMedium
google	SocialMedium
instagram	SocialMedium
twitter	SocialMedium
website	SocialMedium
vkontakte	SocialMedium
account	SocialMedium
press	NewsMedium
media	NewsMedium
guardian	NewsMedium
magazine	NewsMedium
bellingcat	NewsMedium
information	InformationObject
source	InformationObject
evidence	InformationObject
question	InformationObject
certificate	InformationObject
key	InformationObject
number	MeasuringUnit
unit	MeasuringUnit
digit	MeasuringUnit
frame	MeasuringUnit
kilometer	MeasuringUnit
factory	FAC
PowerPlant	FAC
hospital	FAC
dam	FAC
base	FAC
motorway	FAC
airport	FAC
gasStation	FAC
august	Time
day	Time
date	Time
town	UrbanArea
city	UrbanArea
section	UrbanArea
centre	UrbanArea
place	UrbanArea
street	UrbanArea
avenue	UrbanArea
boulevard	UrbanArea
intersection	UrbanArea
crossing	UrbanArea
border	UrbanArea
route	UrbanArea
farmland	RuralArea
field	RuralArea
hill	RuralArea
location	Loc
earth	Loc
territory	Loc
site	Loc
region	Loc
area	Loc
point	Loc
circle	Loc
line	Loc
side-on	Loc
odnoklassniki	Loc
kamensk-shakhtinsky	Loc
zuhres	Loc
kyiv	Loc
donetsk	Loc
luhansk	Loc
olkhovatka	Loc
alexeyevka	Loc
dnepropetrovsk	Loc
snizhne	Loc
oskol	Loc
kursk	Loc
shakhtarsk	Loc
stary	Loc
krasnoarmeysk	Loc
makiivka	Loc
torez	Loc
millerovo	Loc
camouflage	ShapeAndStructureAbstraction
shadow	ShapeAndStructureAbstraction
system	ImmeasurableObject